000000000000000000000000000
000000000003000000000000000
000000000001111110000000000
000000000001111110000000000
000000000001111110000000000
000000000001111110000000000
000000000001111110000000000
000000000001111110000000000
000000000001111110000000000
000000000001111110000000000
000000000001111110000000000
000000000001111110000000000
000000000001111110000000000
000000000001111110000000000
000000000021111110000000000
000000000020000004000000000
000000000022222222000000000
000000000000000000000000000