000000000000000000000000000
002220202022022022000000000
020200202020202022000000000
022200222020002020000000000
000000000000000000000000000
000000000000000000000000000
000000000000000000000000000
000000000000000000000000000
000000000000400000000000000
000000000002222222222222222
000000000022222222222222222
000000000222222222222222222
000000121222222222222222222
300011222222222222222222222
222222222222222222222222222
000000000000000000000000000
000000000000000000000000000
000000000000000000000000000