000000000000000000000000000
000000000000000000000000000
000000000000000000000000000
000000000000000000000000000
000030000000000000000000000
002222222200000000000000000
000000000000000000000000000
000000000000000000000000000
000000000000000000000000000
000000000000000000000000000
000000000000000000000000000
000000000000000000000000000
000000000000000000000000004
222222222222222222222222222
000000000000000000000000000
000000000000000000000000000
000000000000000000000000000
000000000000000000000000000