000000000000000000000000000
000111111111111110000000000
011110000000000011111000000
011000000000000000111000000
011300000000000000011000000
011111111111111111111000000
000000000012210000000000000
020002020012210002220002000
002020020012210002000022000
000200020012210002220202000
000000000012210000020002000
000000000012210002220002000
000000000012210000000000000
000000000012210000000000000
000000000012210000000400000
000111111111111111111110000
000112222222222222222110000
000111111111111111111110000